+-+-+-+-+-+
|   |     |
+-+ +-+-+ +
|     |   |
+ +-+ + +-+
| | | |   |
+ + + +-+ +
|   |     |
+-+-+-+-+-+
